--w-----w---w-----
--------w---------
--w-----w---w-----
--w-----w---w-----
wwwww-wwwwwwwww-ww
---w----w----w----
---w---------w----
--------w---------
wwwwwwwww---------
w-------wwwwwww-ww
--w-----w---w-----
--------w---------
--w---------w-----
--w-----w---w-----
wwwww-wwwwwwwww-ww
---w-----w---w----
---w-----w---w----
---------w--------